1111111111
1P0000C001
1000000001
10000000E1
100C000001
1111111111